####       #####  ##
# ## ######### ###
### ##B#####    ####
   ##   #########
   ##   ###   ###
##  ######    ###
A  ### ######   ###